0    10   11   12   10   11   12   10   11   12   10   11   12   10   11   12   10   11   12   10   11   12   10   11   12   0    0 
10   1    2    3    1    2    3    1    2    3    1    2    3    1    2    3    1    2    3    1    2    3    1    2    3    11   12
13   4    5    6    4    5    6    4    5    6    4    5    6    4    5    6    4    5    6    4    5    6    4    5    6    14   15
16   7    8    9    7    8    9    7    8    9    7    8    9    7    8    9    7    8    9    7    8    9    7    8    9    17   18
10   1    2    3    19   20   15   13   14   15   13   14   15   13   14   15   13   14   15   13   14   22   1    2    3    11   12
13   4    5    6    14   21   18   16   17   18   16   17   18   16   17   18   16   17   18   16   17   23   4    5    6    14   15
16   7    8    9    17   18   0    0    0    0    0    0    0    0    0    0    0    0    0    0    0    16   7    8    9    17   18
10   1    2    3    11   12   0    0    0    0    0    0    0    0    0    0    0    0    0    0    0    10   1    2    3    11   12
13   4    5    6    14   15   0    0    0    0    0    0    0    0    0    0    0    0    0    0    0    13   4    5    6    14   15
16   7    8    9    17   18   0    0    0    0    0    0    0    0    0    0    0    0    0    0    0    16   7    8    9    17   18
10   1    2    3    11   12   0    0    0    0    0    0    0    0    0    0    0    0    0    0    0    10   1    2    3    11   12
13   4    5    6    14   15   0    0    0    0    0    0    0    0    0    0    0    0    0    0    0    13   4    5    6    14   15
16   7    8    9    17   18   0    0    0    0    0    0    0    0    0    0    0    0    0    0    0    16   7    8    9    17   18
10   1    2    3    11   12   0    0    0    0    0    27   0    0    0    28   0    0    0    0    0    10   1    2    3    11   12
13   4    5    6    14   15   0    0    0    0    0    0    0    0    0    0    0    0    0    0    0    13   4    5    6    14   15
16   7    8    9    17   18   0    0    0    0    0    0    0    0    0    0    0    0    0    0    0    16   7    8    9    17   18
10   1    2    3    11   12   0    0    0    0    0    0    0    0    0    0    0    0    0    0    0    10   1    2    3    11   12
13   4    5    6    14   15   0    0    0    0    0    0    0    0    0    0    0    0    0    0    0    13   4    5    6    14   15
16   7    8    9    17   18   0    0    0    0    0    0    0    0    0    0    0    0    0    0    0    16   7    8    9    17   18
10   1    2    3    11   12   0    0    0    0    0    0    0    0    0    0    0    0    0    0    0    10   1    2    3    11   12
13   4    5    6    14   15   0    0    0    0    0    0    0    0    0    0    0    0    0    0    0    13   4    5    6    14   15
16   7    8    9    24   25   12   10   11   12   10   11   12   10   11   12   10   11   12   10   11   26   7    8    9    17   18
10   1    2    3    1    2    3    1    2    3    1    2    3    1    2    3    1    2    3    1    2    3    1    2    3    11   12
13   4    5    6    4    5    6    4    5    6    4    5    6    4    5    6    4    5    6    4    5    6    4    5    6    14   15
16   7    8    9    7    8    9    7    8    9    7    8    9    7    8    9    7    8    9    7    8    9    7    8    9    17   18
0    13   14   15   13   14   15   13   14   15   13   14   15   13   14   15   13   14   15   13   14   15   13   14   15   0    0
0    16   17   18   16   17   18   16   17   18   16   17   18   16   17   18   16   17   18   16   17   18   16   17   18   0    0